....................
.###.###..##..##.##.
..#..#...#..#.#.#.#.
..#..###.####.#...#.
..#..#...#..#.#...#.
..#..###.#..#.#...#.
....................
.........GGG........
.........---........
........-...-.......
....GGG..---..GGG...
....###.-...-.###...
.........---........
.1.....D.....D....X.
####################
